111111011111
100001110001
102200000151
102014440001
100011111111
11111
