111111
100001
101501
102301
104301
100001
111111
