00000011111
00000014001
00000014101
11111114101
10502020201
10101010111
100000001
111111111
