20 10
4 4 4 4 4 4 4 4 4 4 4 4 4 4 4 4 4 4 4 4
4 5 0 0 0 0 1 0 0 0 0 0 0 0 0 0 0 0 5 4
4 7 0 0 0 0 0 3 3 1 1 3 3 0 1 0 0 0 0 4
4 1 0 0 0 1 1 0 0 0 0 0 0 1 7 1 0 0 1 4
4 6 1 0 0 1 1 0 0 0 0 0 0 1 1 0 0 0 1 4
4 1 0 0 3 0 0 0 0 0 0 0 0 0 0 3 0 1 6 4
4 1 0 0 0 1 1 1 1 0 0 0 0 1 0 0 0 0 1 4
4 0 0 0 0 0 0 0 0 3 0 0 0 0 0 0 0 0 0 4
4 5 0 0 0 0 1 0 0 0 0 0 0 1 0 0 0 0 5 4
4 4 4 4 4 4 4 4 4 4 4 4 4 4 4 4 4 4 4 4