20 10
4 4 4 4 4 4 4 4 4 4 4 4 4 4 4 4 4 4 4 4
4 5 2 0 3 0 0 2 0 0 0 0 0 1 7 2 0 2 5 4
4 2 2 0 0 2 0 3 0 2 0 2 0 0 2 3 0 2 2 4
4 0 0 0 1 0 0 0 1 0 1 0 4 3 0 2 6 0 0 4
4 0 0 0 0 0 4 4 0 0 0 3 3 0 0 2 3 3 2 4
4 2 3 2 2 0 0 7 1 0 1 0 0 4 4 0 0 0 0 4
4 0 0 6 3 0 4 4 0 0 0 0 0 4 4 0 0 0 0 4
4 2 2 0 2 0 4 0 0 4 4 0 2 0 1 0 0 2 2 4
4 5 2 0 3 0 0 0 0 0 2 0 0 2 0 0 0 2 5 4
4 4 4 4 4 4 4 4 4 4 4 4 4 4 4 4 4 4 4 4