20 10
4 4 4 4 4 4 4 4 4 4 4 4 4 4 4 4 4 4 4 4
4 5 0 2 0 0 0 0 0 7 0 0 0 0 0 0 2 0 5 4
4 0 0 0 4 4 2 2 4 4 4 4 2 2 4 4 0 0 0 4
4 0 0 2 0 0 0 0 0 0 0 0 0 0 0 0 2 0 0 4
4 0 0 4 4 4 0 0 0 0 0 0 0 0 4 4 4 0 0 4
4 2 2 0 0 6 3 3 0 0 0 0 0 3 3 0 0 2 2 4
4 0 0 2 0 0 0 0 0 0 0 0 0 0 0 0 2 0 0 4
4 0 0 0 4 4 2 2 4 4 4 4 2 2 4 4 6 0 0 4
4 5 0 2 0 0 0 0 0 0 7 0 0 0 0 0 2 0 5 4
4 4 4 4 4 4 4 4 4 4 4 4 4 4 4 4 4 4 4 4